[grid]
  size: (81 x 47)
  encodings: LAVA(L) PLANK(p) GRASS(g) TREE(T) TREES(E) FLOWER(f) WALL(W)
    ROCK(R) LILY(l) FENCE(F) WATER(Z) HUSK(H) HUSKS(I) ROAD(r) HOUSE(h)
    REED(D) SIGN(S) ALGAE(A) TILE(t) TOWER (G)
    BRICK(K) RUBBLE(Q) CLIFF(c) BOG(o)
  data: """
EEEEEEEEEEEEEEEEEEEEEEEEEEEEEEEEEEEEEEEZZlZZWWWWWWWWWWWWWWWWWEEEEEEEEEEEEEEEEEEEE
EZZZZA           S  EEEEEEEE  f    E EEZZlZW                WE                  E
EZZZ      rrrr  rr     f   f EEEE EE EEZZZZW                WE                  E
E       r        FFFEEEEEEEEEEE E EE EEllZZW                   	                E
E h    rr  h        EZA    f   f      EZZZZW                                    E
E                   EZZAE EEEEE EEEEEEEZZlZW                                    E
E    h              EZpZE E   E E     EZlZZW                WE                  E
E             h     EZZpErE   E EEEEE EZZlZW                WE                  E
E                   EZZEErE   E       EZZZZW                WEEEEEEEEEEEEEEEEEEEE
EEEEEEEEEEEEEEEEEEEEEEEEE EEEEEEEEEEEEEZZZW                 W                   W
E                                  AZZZZZW                  W                   W
EAA   T  AT   AA A T    ttt     AAZZZZZZZW                  W                   W
ZZZZZZZZZZZZZZZZZZZZZZZZtttZZZZZZZZZllZZZZWWW               W                   W
ZZZZZZlZZZZZZZZlZZllZZZZtttttZZlZZZZZZZZZZZZZW              W                   W
ZZlZZZZlZZZlZZZZZZZZZlZZtttttZZZZZZZ     ZlZZZW             W                   W
ZZZZZZlZZZZZZZZllZZZZZZZZZtttZZ      FFF  EEEEW             W                   W
ZZZZZllZZZZZZZZZZZZ      ttt       FF hF EEEEEW             W                   W
ZZZZZZZZZllZZZ             r     FFFF  EEEEEEEW             W                   W
EEEEEEEEEEEEEEEEEEEEEEEEEE   EEEEEEEEEEEEEEEEEW             W                   W
WWWWWWWWWWWWWWWWWWWWWWWWWW   WWWWWWWWWWWWWWWWWW             W                   W
W                                                           W                   W
W                                                           W                   W
W                                                           W                   W
W                                                           W                   W
W                                                           W                   W
WWWWWWWWWWWWWWWWWWWWWWWWWWWWWWWWWWWWWWWWWWWWWWWWWWWWWWWWWW WW                   W
W                                                           W                   W
W                                                           W                   W
W                                                           W                   W
W                                                           W                   W
W                                                           W                   W
W                                                           W                   W
W                                                           W                   W
W                                                           W                   W
W                                                                               W
W                                                           W                   W
W                                                           W                   W
W                                                           W                   W
W                                                           W                   W
W                                                           W                   W
W                                                           W                   W
W                                                           W                   W
W                                                           W                   W
W                                                           W                   W
W                                                           W                   W
W                                                           W                   W
WWWWWWWWWWWWWWWWWWWWWWWWWWWWWWWWWWWWWWWWWWWWWWWWWWWWWWWWWWWWWWWWWWWWWWWWWWWWWWWWW
"""

[element]
  skin: DOOR
  position: (2, 21)
  locked: KEY green

[element]
  name: fluffy
  player: true
  skin: BABA
  position: (8,7)
  health: 10

[element]
  name: durendale
  skin: SWORD
  position: (32,6)
  kind: item
  damage: 15

[element]
  name: green
  skin: KEY
  position: (5,1)
  kind: item
  
[element]
  name: blue
  skin: KEY
  position: (36,1)
  kind: item

[element]
  skin: DOOR
  position: (26,9)
  locked: KEY blue

[element]
  name: statue
  skin: STATUE
  position: (25,20)
  kind: obstacle
[element]
  name: statue
  skin: STATUE
  position: (28,20)
  kind: obstacle
[element]
  name: statue
  skin: STATUE
  position: (60,2)
  kind: obstacle
[element]
  name: statue
  skin: STATUE
  position: (60,5)
  kind: obstacle




[element]
  name: waldo
  skin: CRAB
  position: (38, 24)
  kind: enemy
  health: 10
  zone: (38, 24) (10 x 8)
  behavior: agressive
  damage: 5

[element]
  name: piano
  skin: PIANO
  position: (63,38)
  kind: obstacle

[element]
  name: chair
  skin: CHAIR
  position: (54,44)
  kind: obstacle

[element]
  name: table
  skin: TABLE
  position: (55,43)
  kind: obstacle

[element]
  name: bed
  skin: BED
  position: (38,45)
  kind: obstacle
  
[element]
  skin: BURGER
  position: (6, 6)
